*** Unesim capitul (/course/5677798/salute-jonathan-un-occidental-interlingue-cursu/1/)
bon	good
cité	city
dir	to say
e	and
es	is (definition)
esser	to be (definition)
esque	is that
grand	big
il	he
in	in
inteligent	intelligent
it	it
jurnale	journal
li	the
mann	man
may	May
ne	not
no	no
pensar	to think
pri	about
que	that (conjunction)
quo	what
salute	salute
scrir	to write
star	to be (location)
tren	train
u	where
un	a/one
vider	to see
yes	yes
*** Duesim capitul (/course/5677798/salute-jonathan-un-occidental-interlingue-cursu/2/)
a	to
amar	to love
de	of
deman	tomorrow
die	day
hodíe	today
ma	but
mult	many
nov	new
nu	now
old	old
va	will
viage	journey
viagear	to travel
yer	yesterday
yo	I
*** Triesim capitul (/course/5677798/salute-jonathan-un-occidental-interlingue-cursu/3/)
bell	beautiful
bifstec	beefsteak
bir	beer
deci	ten
decidu	twelve
deciquar	fourteen
deciquin	fifteen
decitri	thirteen
deciun	eleven
departer	to leave
desbell	ugly
du	two
far	to do
felici	happy
haver	to have
hay	there is
hora	o'clock
idé	idea
manjar	to eat
mi	my
minus	minus
minute	minute
moment	moment
o	or
ott	eight
plu	more
por	for
problema	problem
quam!	how!
quel	which (which one/thing)
saver	to know
sett	seven
tard	late
témpor	time
tre	very
tri	three
trincar	to drink
ye	at
*** Quaresim capitul (/course/5677798/salute-jonathan-un-occidental-interlingue-cursu/4/)
al	to the
altri	other
amíco	friend
anc	also
Anglia	England
anglés	english
benevenit	welcome
borgo	town
carte	map
castelle	castle
ci	here
comensar	to begin
comto	earl
con	with
del	of the
diferent	different
dormir	to sleep
finir	to finish
german	german
hotel	hotel
ili	they
interessant	interesting
land	land
leer	to read
lettre	letter
libre	book
loc	place
lontan	far
manjage	food
me	me
minu	less
muséo	museum
nam	because
noi	we
nómine	name
ost	east
parlar	to speak
person	person
ples	please
poc	little
poy	then
quam	than
qui	who
Rumania	Romania
strade	street
su	his/her/its
venir	to come
vor	your (single formal or plural)
west	west
*** Quinesim capitul (/course/5677798/salute-jonathan-un-occidental-interlingue-cursu/5/)
chambre	room
cose	thing
cruce	cross
crucifixe	crucifix
dar	to give
dever	must
ear	to go
fémina	woman
hotelero	keeper
le	him
mal	bad
manu	hand
mersí	thank you
omnicos	everything
plorar	to cry
pos	after
pro quo	why
questionar	ask
santo	saint
sol	alone
strangi	strange
te	you (singal informal, object)
tui	your (single informal)
tu	you (single informal, subject)
vi	here is
vu	you (single formal or plural, subject)
*** Sixesim capitul (/course/5677798/salute-jonathan-un-occidental-interlingue-cursu/6/)
ah!	ah!
alt	high
árbor	tree
atender	to wait
avan	in front of
bass	low
caler	to feel hot
calid	hot
circum	around
coche	coach
cochero	driver
comprender	to understand
continuar	to continue
denov	again
de témpor a témpor	from time to time
forest	forest
friger	to feel cold
frigid	cold
lor	their
matine	morning
micri	small
midí	noon
monte	mountain
mover	to move
pire	pear
piriero	pear tree
pom	apple
pomiero	apple tree
pos-midí	afternoon
pro que	because
prun	plum
pruniero	plum tree
quande	when
quinesim	fifth
rapid	rapid
rapidmen	rapidly
se	himself/herself/itself
seder	to sit
six	six
sole	sun
ti	this (pronoun)
ti-ci	this (adjective)
ti-ta	that (adjective)
trist	sad
vésper	evening
via	path
viver	to live
voler	want to
*** Settesim capitul (/course/5677798/salute-jonathan-un-occidental-interlingue-cursu/7/)
audir	to hear
avanse	advance
bagage	luggage
barbe	beard
can	dog
cavall	horse
descender	to get off
dom	house
ex	out of
excitat	excited
fórsan	perhaps
fort	strong
haltar	to halt
har	to have (grammatical)
hor	hour
inter	between
les	them
long	long
nigri	black
nocte	night
passe	pass
posser	can
prender	to take
quar	four
rich	rich
rider	to laugh
senior	sir/mr.
seniora	madam/mrs.
solmen	only
ta	there
tam	so (very)
to	that (pronoun)
visage	face
voce	voice
*** Ottesim capitul (/course/5677798/salute-jonathan-un-occidental-interlingue-cursu/8/)
ancor	still
aquavite	brandy
blu	blue
calm	calm (adjective)
calmar	to calm (verb)
conducter	to drive
esse	be (imperative)
excellent	excellent
flamme	flame
for	away/out
for!	go away!
forear	to leave
frappar	to knock
horloge	clock
lune	moon
lupo	wolf
mem	even
mi-nocte	midnight
monstrar	to show
nequo	nothing
niver	to snow
nube	cloud
on	one (pronoun)
passar	to pass
sam	same
si	if
silent	silent
son	sound
tornar	to turn
trincage	drink (noun)
ululada	howling
ulular	to howl
vente	wind
vermen	really
vez	time (quantity)
un vez	one time/once
-nt	-ing (adjective)
-nte	-ing (adverb)
*** Ninesim capitul (/course/5677798/salute-jonathan-un-occidental-interlingue-cursu/9/)
ante	before
aperter	to open
aqua	water
arivar	to arrive
auxiliar	to help
blanc	white
blancissim	blank/so white
caseo	cheese
chef	boss
cigare	cigar
citean	citizen
comprar	to buy
detra	behind
durant	during
durant que	while
éxter	outside
fenestre	window
firma	company
fortissim	powerful/so strong
foy	fire
fumar	to smoke
galline	chicken
grandissim	huge/so big
interessar	to interest
intrar	to enter
ja	already
lavar	to wash
lette	bed
moné	money
mort	dead
musica	music
mustache	mustache
oh	oh
pensa	thought (noun)
porta	door
qualmen	how
scaliere	staircase
semblar	seems
sequer	to follow
stante	standing
strax	start
stupid	stupid
vigil	awake
vos	your (single formal or plural)
*** Decesim capitul (/course/5677798/salute-jonathan-un-occidental-interlingue-cursu/10/)
aprender	to learn
argente	silver (noun)
argentin	silver (adjective)
aure	gold (noun)
aurin	gold (adjective)
avigilar	to wake up
bonissim	great/so good
café	coffee
comic	funny
dejuné	breakfast
except	except
forene	foreigner
geografie	geography
grammatica	grammar
historie	history
important	important
lingue	language
naturalmen	certainly
ne ver?	isn't it?
nettar	to clean
null	no
parol	word
serchar	to search
serrar	to lock
spegul	mirror
sur	on
table	table
tasse	cup
trovar	to find
vé	woe
vell	would
ver	true
*** Grammatica (capitul 1-10) (/course/5677798/salute-jonathan-un-occidental-interlingue-cursu/11/)
nomin-e	gender (neutral/male/female)
numer-esim	-th, ordinal numbers
verbe-t	past tense/ past participle
va verbe-r	future tense, will (verb)
verbe-r	infinitive, to (verb)
nomine-s	-s/-es, plural of the (noun)
nomin-ere	professional of the (noun)
ples verbe-r	please (verb)
land-ese	people from that country
nomin-iero	holder/tree of the (noun)
adjectiv-men	adverb of the (adjective)
ha verbe-t	present perfect tense
verbe-nt	present participle, adjective
verbe-nte	present participle, adverb
verb-age	thing which the (verb) act on
adjectiv-issim	very very (adjective)
vell verbe-r	conditional, would (verb)
nomin-in	thing made in the (noun)
*** Deciunesim capitul (/course/5677798/salute-jonathan-un-occidental-interlingue-cursu/12/)
a revidentie	see you
adver	indeed
alor	in that case/ at that time
ancian	ancient
annu	year
asil	asylum
ciel	sky
circumité	surroundings
creder	to believe
fatigat	tired
gris	grey
inteligentissim	genius/ so intelligent
laborar	to work
lunatico	lunatic
pardon	sorry
parlada	conversation
posdeman	day after tomorrow
qual	which (which is/are)
question	question
retornar	to return
revider	to see again
settcent	seven hundred
surnómine	surname
tresor	treasure
vidente	seeing
*** Deciduesim capitul (/course/5677798/salute-jonathan-un-occidental-interlingue-cursu/13/)
col	neck
exear	to leave
jettar	to throw
jorne	daytime
malissim	awful/ so bad
li max	the most
prison	prison
quelc	some
rasar	to shave
rasuore	shaver
sanguar	to bleed
sangue	blood
self	oneself
tra	through
usar	to use
vader	to walk
*** Decitriesim capitul (/course/5677798/salute-jonathan-un-occidental-interlingue-cursu/14/)
amate	lover
amico	friend
consonante	consonant
dangere	danger
dangerosi	dangerous
geste	gesture
mensu	month
papere	paper
parte	part
standar	to be (good/bad)
stenografie	stenography/shorthand
vocale	vowel
*** Deciquaresim capitul (/course/5677798/salute-jonathan-un-occidental-interlingue-cursu/15/)
adjective	adjective
adverbie	adverb
antiqui	old/ancient
bellitá	beauty
cap	head
clave	key
cluder	to close
Deo	God
dunc	thus/so
fortie	force
grimpar	to climb
haha	haha
líber	to be free
memorar	to remember
mur	wall
nullcos	nothing
obliviar	to forget
ocul	eye
omni	all
prisonario	prisoner
proxim die	next day
rapiditá	speed
sin	without
substantive	noun
tis	these
valley	valley
veritá	truth
verbe	verb
*** Deciquinesim capitul (/course/5677798/salute-jonathan-un-occidental-interlingue-cursu/16/)
amore	love (noun)
bellissim	glorious/ so beautiful
besar	to kiss
bocca	mouth
calore	hot (noun)
capilles	hair (plural)
conosser	to know/recognise
contra	against/towards
demon	demon
dente	tooth
ella	she
ellas	they (female)
frigore	cold (noun)
ho-nocte	tonight
illos	they (male)
instante	moment/instant
la	her
las	them (female)
li mi	mine
los	them (male)
necú	nowhere
neproquo	you are welcome/ never mind
nequande	never
nequi	no one
nor	we
nos	us
rememorar	to recall
rise	laugh (noun)
sac	bag
secun	according to
sentir	to feel
signe	signal
timer	to fear
tro	too (quantity)
yun	young
*** Decisixesim capitul (/course/5677798/salute-jonathan-un-occidental-interlingue-cursu/17/)
alcú	somewhere
alcun	some
alquande	sometimes
alqui	someone
alquo	something
benque	although
ca	whether
curiosi	curious
decinin	ninteen
deventie	duty
duantnin	twenty-nine
facil	easy
junio	june
movement	movement
parlament	parliament
posta	post/ post office
presc	almost
reve	dream
sentiment	feeling/sentiment
talmen	suchly/ in this way
tam...quam	as...as
til	until
timore	fear (noun)
vestiment	clothes
*** Decisettesim capitul (/course/5677798/salute-jonathan-un-occidental-interlingue-cursu/18/)
aportar	to bring
cert	sure
cigane	gypsy
currer	to run
devenir	to become
É!	Hey!
importar	to import/ to have meaning
ínfelici	unhappy
levar se	to stand up/ to get up
nominar	to name
portar	to carry/wear
revar	to dream
*** Deciottesim capitul (/course/5677798/salute-jonathan-un-occidental-interlingue-cursu/19/)
apu	beside/ next to
baston	stick/staff/baton/rod
beson	need
besonar	to need
buxe	box/bin
carre	cart
colere	anger
cri	cry/shout/scream
criar	to cry/shout/scream
desfacil	difficult
filie	child (son/daughter)
gente	people
micrissim	tiny/ so small
monstru	monster
necós	nothing
ni...ni	neither...nor
per	by
permanjar	to eat up
posseder	to own/have
punctu	dot/point
scrite	script
sempre	always
slovacos	slovaks
tost	soon/early
tot	whole/all
*** Decininesim capitul (/course/5677798/salute-jonathan-un-occidental-interlingue-cursu/20/)
altres	others
auxilie	help (noun)
capella	chapel
córpor	body
grimpada	climb (noun)
ínpossibil	impossible
Italia	Italy
misser	to send
morir	to die
morte	death
odore	smell/odor
oldissim	so old
petir	ask for/ demand
polve	dust
quant	how many
scalun	stair
stul	chair
suol	ground/floor
ultim	last/final
vers	towards
*** Duantesim capitul (/course/5677798/salute-jonathan-un-occidental-interlingue-cursu/21/)
altricos	something/ some other things
apert	opened
biblioteca	library
che	home
coverte	cover
esperar	to hope
horrore	horror
litt	little
marchar	to march
mey	may
morto	corpse
multissim	so many/ so much
odiar	to hate
pede	foot
pistol	pistol
rubi	red
silentie	silence/quiet
subrider	to smile
terrore	terror
*** Grammatica (capitul 11-20) (/course/5677798/salute-jonathan-un-occidental-interlingue-cursu/22/)
verbe-da	continuing action of the (verb)
re-verber	do the (verb) again
verbe-ntie	-nce, state of the (verb)
nomin-ité	-ity, totality of the (noun)
verb-or	-or, a person/thing who do the (verb)
nomin-arie	a person characterised by the (noun)
verbe-te	a person whom one (verb-ed)
verbe-nte	a person whom one is (verb-ing)
verbe-bil	able to (verb)
adjectiv-itá	-ity, the quality of the (adjective)
adjectiv-ie	-y/-ce, noun of the (adjective)
verb-e	noun of the (verb)
verb-ore	state of the (verb)
ho-nomine	to-, this (noun)
ne-qux	no-, absence/negation pronoun
al-qux	some-, indefinite pronoun
verbe-ment	-ment, concrete action of the (verb) or its result
ín-adjectiv	in-, negation of the (adjective)
per-verber	per-, through/ to the end
adjectiv-e	noun of the (adjective)
nomin-un	single of the (noun)
nomin-iere	containing the (noun)
mey verbe-r	may (verb)
